1111111111111111111111111111
1PCCCCCCCCCCC11CCCCCCCCCCCC1
1C1111C11111C11C11111C1111C1
1C1111C11111C11C11111C1111C1
1C1111C11111C11C11111C1111C1
1CCCCCCCCCCCCCCCCCCCCCCCCCC1
1C1111C11C11111111C11C1111C1
1C1111C11C11111111C11C1111C1
1CCCCCC11CCCC11CCCC11CCCCCC1
111111C11111C11C11111C111111
000001C11111C11C11111C100000
000001C11CCCCCCCCCC11C100000
000001C11C111BB111C11C100000
000001C11C15000041C11C100000
000001CCCC10000001CCCC100000
000001C11C12000031C11C100000
000001C11C11111111C11C100000
000001C11CCCCCCCCCC11C100000
000001C11C11111111C11C100000
111111C11C11111111C11C111111
1CCCCCCCCCCCC11CCCCCCCCCCCC1
1C1111C11111C11C11111C1111C1
1C1111C11111C11C11111C1111C1
1CCC11CCCCCCCCCCCCCCCC11CCC1
111C11C11C11111111C11C11C111
111C11C11C11111111C11C11C111
1CCCCCC11CCCC11CCCC11CCCCCC1
1C1111111111C11C1111111111C1
1C1111111111C11C1111111111C1
1CCCCCCCCCCCCPCCCCCCCCCCCCC1
1111111111111111111111111111