WWWWWWWWWWWWWWWWWWWWWWWWWWWW
WCCCCCCCCCCCCWWCCCCCCCCCCCCW
WCWWWWCWWWWWCWWCWWWWWCWWWWCW
WCWWWWCWWWWWCWWCWWWWWCWWWWCW
WCWWWWCWWWWWCWWCWWWWWCWWWWCW
WCCCCCCCCCCCCCCCCCCCCCCCCCCW
WCWWWWCWWCWWWWWWWWCWWCWWWWCW
WCWWWWCWWCWWWWWWWWCWWCWWWWCW
WCCCCCCWWCCCCWWCCCCWWCCCCCCW
WWWWWWCWWWWWCWWCWWWWWCWWWWWW
00000WCWWWWWCWWCWWWWWCW00000
00000WCWWCCCCCCCCCCWWCW00000
00000WCWWCWWWBBWWWCWWCW00000
00000WCWWCW100002WCWWCW00000
00000WCCCCW000000WCCCCW00000
00000WCWWCW300004WCWWCW00000
00000WCWWCWWWWWWWWCWWCW00000
00000WCWWCCCCCCCCCCWWCW00000
00000WCWWCWWWWWWWWCWWCW00000
WWWWWWCWWCWWWWWWWWCWWCWWWWWW
WCCCCCCCCCCCCWWCCCCCCCCCCCCW
WCWWWWCWWWWWCWWCWWWWWCWWWWCW
WCWWWWCWWWWWCWWCWWWWWCWWWWCW
WCCCWWCCCCCCCCCCCCCCCCWWCCCW
WWWCWWCWWCWWWWWWWWCWWCWWCWWW
WWWCWWCWWCWWWWWWWWCWWCWWCWWW
WCCCCCCWWCCCCWWCCCCWWCCCCCCW
WCWWWWWWWWWWCWWCWWWWWWWWWWCW
WCWWWWWWWWWWCWWCWWWWWWWWWWCW
WCCCCCCCCCCCCPCCCCCCCCCCCCCW
WWWWWWWWWWWWWWWWWWWWWWWWWWWW